111111111111111111
10000C001010100001
111011100010001P01
111011111010111E01
101000110000001C01
100010011011111111
1C10110000000000C1
111111110111111111
