111111111111111111111111111111
1C01111000C1110000C0000C000001
100011000000000000000110000E01
100011000000000010000100000001
10000000000C000000000000000001
100000000000000011000001111111
10P011111000000000000001111111
1000111111C0000000000011111111
111111111111111111111111111111