1111111111111111111111111
1110000000000000000000111
100000000000P000000000011
1000000000000000000000001
1000000000C00000000000001
1100000000E00000000000011
1110000000000000000000111
1111111111111111111111111
