1111111111111111111111111
111C100000000000000000111
101110000000P000000000011
1111111101111111111111111
1000000000C00000000000001
1100000000E00000000000011
1110000000000000000000111
1111111111111111111111111
